#...................................#
#...................................#
#.....$.....$.......................#
#............$......................#
#.......$.........$.............$...#
#...................................#
#.....#########################.....#
#.....##!...................!##.....#
#..$..#.#!...$.......$.....!#.#.....#
#.....#..#!...............!#..#.....#
#.....#...#...............#...#...$.#
#.....#....#.............#....#..$..#
#.....#.....#......$....#.....#.....#
#.$...#......#.........#......#.....#
#.....#.......#.......#....$..#.....#
#.....#....$..................#.....#
#.....#.........#...#.........#.....#
#...$.#..........#.#...$......#..$..#
#.....#...........@...........#.....#
#.....#...$......#.#..........#.....#
#.....#.........#...#.....$...#.....#
#..$..#.......................#.....#
#.....#.......#.......#.......#.....#
#.....#......#.........#......#..$..#
#.....#.....#......$....#.....#.....#
#..$..#....#.............#....#.....#
#.....#...#...............#...#.....#
#.....#..#!...............!#..#..$..#
#...$.#.#!.....$......$....!#.#.$...#
#..$..##!...................!##.....#
#.....#########################.....#
#........$..........................#
#................$....$.............#
#...........$.......$...............#
#...................................#
#...................................#
#...................................#